'

CONTENIDOS: Unidad Didáctica I: Cinesiterapia.
Generalidades Unidad Didáctica II: Cinesiterapia articular
pasiva. Unidad Didáctica III: Cinesiterapia articular
activa. Unidad Didáctica IV: Poleoterapia y
mecanoterapia. 

CONTENIDOS TEÓRICOS: 
Unidad didáctica I: Cinesiterapia. Generalidades.
Unidad didáctica II: Bases físicas de la
Cinesiterapia.
Unidad didáctica III: Cinesiterapia pasiva.
Unidad didáctica IV: Tracciones y elongaciones.
Unidad didáctica V: Posturas osteoaticulares.
Unidad didáctica VI: Estiramientos.
Unidad didáctica VII: Manipulaciones.
Unidad didáctica VIII: Cinesiterapia activa.
Unidad didáctica IX: Fuerza, resistencia y potencia.
Unidad didáctica X: Cinesiterapia activa
específica. 
Unidad didáctica XI: Mecanoterapia.
Unidad didáctica XII: Suspensionterapia.
Unidad didáctica XIII: Poleoterapia.
Unidad didáctica XIV: Ayudas técnicas para la
deambulación.
Unidad didáctica XV: Hidrocinesiterapia.
 
CONTENIDOS PRÁCTICOS:
Unidad práctica I: Cinesiterapia pasiva de cadera y
rodilla.
Unidad práctica II: Cinesiterapia pasiva de
tobillo-pie.
Unidad práctica III: Cinesiterapia activa de cadera y
rodilla.
Unidad práctica IV: Cinesiterpia activa de
tobillo-pie.
Unidad práctica V: Cinesiterapia pasiva de hombro
Unidad práctica VI: Cinesiterpia pasiva de codo y
mano.
Unidad práctica VII: Cinesiterapia activa de hombro.
Unidad práctica VIII: Cinesiterapia activa de codo y
mano.
Unidad práctica IX: Mecanoterapia.
Unidad práctica X: Poleoterapia.
'